#####A#####
####  #  ##
##   ##  ##
#  ########
#  ###  #B#
#         #
###########
