#######A##
####    ##
##      ##
## B###  #
##########
